5
10
111111111111
100002000001
101000000101
100100001001
100010010001
100001100001
100001100001
100010010001
100100001001
101000000101
100000000001
111111111111